fecha,concepto,folio,cargo,abono,saldo,numero_control
25-08,DEPOSITO EFECTIVO PRACTIC/******7724,3164,,"$2,900.00","$8,388,489.61",21690351
25-08,DEPOSITO EFECTIVO PRACTIC/******7724,5848,,"$2,900.00","$8,385,589.61",21690103
25-08,DEPOSITO EFECTIVO PRACTIC/******7724,4018,,"$2,900.00","$8,382,689.61",21690547
25-08,DEPOSITO EFECTIVO PRACTIC/******7724,6943,,"$2,900.00","$8,379,789.61",21690599
25-08,DEPOSITO EFECTIVO PRACTIC/******7724,7265,,"$2,900.00","$8,376,889.61",21690241
25-08,DEPOSITO EFECTIVO PRACTIC/******7724,6940,,"$2,900.00","$8,373,989.61",21690347
25-08,DEPOSITO EFECTIVO PRACTIC/******7724,4187,,"$2,900.00","$8,371,089.61",21690275
25-08,DEPOSITO EFECTIVO PRACTIC/******7724,0800,,$150.00,"$8,368,189.61",22690186
25-08,DEPOSITO EFECTIVO PRACTIC/******7724,9850,,"$2,900.00","$8,368,039.61",21690050
25-08,DEPOSITO EFECTIVO PRACTIC/******7724,6927,,"$2,900.00","$8,365,139.61",21690306
25-08,DEPOSITO EFECTIVO PRACTIC/******7724,9835,,"$3,500.00","$8,362,239.61",21690387
25-08,DEPOSITO EFECTIVO PRACTIC/******7724,6916,,"$2,900.00","$8,358,739.61",21690324
25-08,DEPOSITO EFECTIVO PRACTIC/******7724,5812,,"$2,900.00","$8,355,839.61",20690296
25-08,DEPOSITO EFECTIVO PRACTIC/******7724,6913,,"$2,900.00","$8,352,939.61",21690261
25-08,DEPOSITO EFECTIVO PRACTIC/******7724,6911,,"$2,900.00","$8,350,039.61",21690221
25-08,DEPOSITO EFECTIVO PRACTIC/******7724,9828,,$150.00,"$8,347,139.61",
25-08,DEPOSITO EFECTIVO PRACTIC/******7724,5801,,$450.00,"$8,346,989.61",21690074
25-08,DEPOSITO EFECTIVO PRACTIC/******7724,0787,,"$1,050.00","$8,346,539.61",21690074
25-08,DEPOSITO EFECTIVO PRACTIC/******7724,0785,,"$1,400.00","$8,345,489.61",21690074
25-08,DEPOSITO EFECTIVO PRACTIC/******7724,3980,,"$2,900.00","$8,344,089.61",19690405
25-08,DEPOSITO EFECTIVO PRACTIC/******7724,5055,,"$2,900.00","$8,341,189.61",21690160
25-08,DEPOSITO EFECTIVO PRACTIC/******7724,5783,,"$2,900.00","$8,338,289.61",21690444
25-08,DEPOSITO EFECTIVO PRACTIC/******7724,6863,,"$2,900.00","$8,335,389.61",19690395
25-08,DEPOSITO EFECTIVO PRACTIC/******7724,5043,,$150.00,"$8,332,489.61",23690586
25-08,23690586 6052 FOLIO:5043,,,"$2,900.00","$8,332,339.61",
25-08,DEPOSITO EFECTIVO PRACTIC/******7724,0745,,$200.00,"$8,329,439.61",25690316
25-08,AGO25 14:37 PRAC A612 FOLIO:0745,,,"$2,500.00","$8,329,239.61",21690364
25-08,DEPOSITO EN EFECTIVO,,,"$2,900.00","$8,326,739.61",21690364
25-08,DEPOSITO EFECTIVO PRACTIC/******7724,5030,,$150.00,"$8,323,839.61",21690076
25-08,DEPOSITO EFECTIVO PRACTIC/******7724,5027,,$150.00,"$8,323,689.61",21690076
25-08,DEPOSITO EFECTIVO PRACTIC/******7724,9761,,$150.00,"$8,323,539.61",21690169
25-08,DEPOSITO EFECTIVO PRACTIC/******7724,9759,,$150.00,"$8,323,389.61",21690100
25-08,DEPOSITO EFECTIVO PRACTIC/******7724,9757,,$150.00,"$8,323,239.61",21690100
25-08,DEPOSITO EFECTIVO PRACTIC/******7724,9755,,"$2,900.00","$8,323,089.61",21690413
25-08,CHEQUE PAGADO NO./0008880,,$300.00,,"$8,320,189.61",
25-08,DEPOSITO EFECTIVO PRACTIC/******7724,5744,,$150.00,"$8,320,489.61",21690364
25-08,DEPOSITO EFECTIVO PRACTIC/******7724,0697,,$600.00,"$8,320,339.61",23690341
25-08,DEPOSITO EFECTIVO PRACTIC/******7724,5741,,$150.00,"$8,319,739.61",21690364
25-08,21690364 4543 FOLIO:5741,,,"$2,900.00","$8,319,589.61",19690445
25-08,DEPOSITO EN EFECTIVO/00ITCV 19690445,,,"$2,900.00","$8,316,689.61",19690445
25-08,CHEQUE PAGADO NO./0008895,,"$19,976.04",,"$8,313,789.61",
25-08,DEPOSITO EFECTIVO PRACTIC/******7724,5729,,$200.00,"$8,333,765.65",23690719
25-08,DEPOSITO EFECTIVO PRACTIC/******7724,0699,,"$2,900.00","$8,333,565.65",21690239
25-08,DEPOSITO EFECTIVO PRACTIC/******7724,5726,,$150.00,"$8,330,665.65",23690719
25-08,DEPOSITO EFECTIVO PRACTIC/******7724,3926,,"$2,900.00","$8,330,515.65",21690381
25-08,DEPOSITO EFECTIVO PRACTIC/******7724,3923,,"$2,900.00","$8,327,615.65",21690036
25-08,ITCV 21690036 5507 FOLIO:3923,,,"$3,500.00","$8,324,715.65",
25-08,DEPOSITO EFECTIVO PRACTIC/******7724,6778,,$300.00,"$8,321,215.65",21690385
25-08,CHEQUE PAGADO NO./0008889,,"$3,600.00",,"$8,320,915.65",
25-08,DEPOSITO EFECTIVO PRACTIC/******7724,6767,,"$2,900.00","$8,324,515.65",21690516
25-08,DEPOSITO EFECTIVO PRACTIC/******7724,3906,,"$2,900.00","$8,321,615.65",21690244
25-08,DEPOSITO EFECTIVO PRACTIC/******7724,5701,,"$2,600.00","$8,318,715.65",24690007
25-08,DEPOSITO EFECTIVO PRACTIC/******7724,3901,,"$2,500.00","$8,316,115.65",25690538
25-08,TRASPASO ENTRE CUENTAS/000000025690349,,,$150.00,"$8,313,615.65",
25-08,DEPOSITO EFECTIVO PRACTIC/******7724,5686,,$150.00,"$8,313,465.65",21690529
25-08,21690529 4543 FOLIO:5686,,,"$2,900.00","$8,313,315.65",
25-08,DEPOSITO EFECTIVO PRACTIC/******7724,3899,,$200.00,"$8,310,415.65",25690710
25-08,DEPOSITO EFECTIVO PRACTIC/******7724,3897,,"$2,900.00","$8,310,215.65",25690710
25-08,DEPOSITO EFECTIVO PRACTIC/******7724,9677,,"$2,900.00","$8,307,315.65",21690073
25-08,DEPOSITO EFECTIVO PRACTIC/******7724,5677,,$150.00,"$8,304,415.65",21690078
25-08,DEPOSITO EFECTIVO PRACTIC/******7724,5674,,$150.00,"$8,304,265.65",21690078
25-08,DEPOSITO EFECTIVO PRACTIC/******7724,5672,,"$2,900.00","$8,304,115.65",21690078
25-08,DEPOSITO EFECTIVO PRACTIC/******7724,9669,,"$3,500.00","$8,301,215.65",25690713
25-08,C25690713 4542 FOLIO:9669,,,"$2,900.00","$8,297,715.65",
25-08,DEPOSITO EFECTIVO PRACTIC/******7724,6715,,$150.00,"$8,294,815.65",22690086
25-08,DEPOSITO EFECTIVO PRACTIC/******7724,0630,,"$2,600.00","$8,294,665.65",24690004
25-08,M24690004 6053 FOLIO:0630,,,$150.00,"$8,292,065.65",
25-08,DEPOSITO EFECTIVO PRACTIC/******7724,5621,,"$3,200.00","$8,291,915.65",21690066
25-08,DEPOSITO EFECTIVO PRACTIC/******7724,9629,,"$2,900.00","$8,288,715.65",25690712
25-08,PAGO CUENTA DE TERCERO/ 0073617475,,,"$1,900.00","$8,285,815.65",
25-08,DEPOSITO EFECTIVO PRACTIC/******7724,3855,,$300.00,"$8,283,915.65",21690054
25-08,DEPOSITO EFECTIVO PRACTIC/******7724,0596,,"$3,500.00","$8,283,615.65",22690052
25-08,DEPOSITO EFECTIVO PRACTIC/******7724,3852,,"$2,900.00","$8,280,115.65",21690054
25-08,ITCV21690054 5507 FOLIO:3852,,,"$2,900.00","$8,277,215.65",
25-08,DEPOSITO EFECTIVO PRACTIC/******7724,0602,,$300.00,"$8,274,315.65",22690268
25-08,22690268 6053 FOLIO:0602,,,$150.00,"$8,274,015.65",25690587
25-08,DEPOSITO EN EFECTIVO/000000025690587,,,$150.00,"$8,273,865.65",25690587
25-08,DEPOSITO EFECTIVO PRACTIC/******7724,3008,,$150.00,"$8,273,715.65",21690286
25-08,DEPOSITO EFECTIVO PRACTIC/******7724,3842,,"$2,900.00","$8,273,565.65",20690008
25-08,DEPOSITO EFECTIVO PRACTIC/******7724,3005,,$150.00,"$8,270,665.65",21690286
25-08,DEPOSITO EFECTIVO PRACTIC/******7724,9591,,"$2,900.00","$8,270,515.65",24690625
25-08,DEPOSITO EFECTIVO PRACTIC/******7724,4813,,"$3,500.00","$8,267,615.65",24690014
25-08,DEPOSITO EFECTIVO PRACTIC/******7724,3828,,"$3,500.00","$8,264,115.65",22690482
25-08,DEPOSITO EFECTIVO PRACTIC/******7724,4811,,"$1,000.00","$8,260,615.65",21690349
25-08,DEPOSITO EFECTIVO PRACTIC/******7724,6613,,"$2,900.00","$8,259,615.65",21690148
25-08,DEPOSITO EFECTIVO PRACTIC/******7724,0578,,"$3,500.00","$8,256,715.65",24690009
25-08,ITCV B24690009 6053 FOLIO:0578,,,"$3,500.00","$8,253,215.65",25690529
25-08,DEPOSITO EN EFECTIVO/000INGL25690529,,,"$2,000.00","$8,249,715.65",25690529
25-08,DEPOSITO EN EFECTIVO,,,"$2,900.00","$8,247,715.65",25690529
25-08,DEPOSITO EFECTIVO PRACTIC/******7724,3802,,"$2,900.00","$8,244,815.65",21690120
25-08,DEPOSITO EFECTIVO PRACTIC/******7724,5540,,$150.00,"$8,241,915.65",21690046
25-08,DEPOSITO EFECTIVO PRACTIC/******7724,9546,,"$2,900.00","$8,241,765.65",22690086
25-08,DEPOSITO EFECTIVO PRACTIC/******7724,2771,,"$2,900.00","$8,238,865.65",21690277
25-08,DEPOSITO EFECTIVO PRACTIC/******7724,5538,,"$2,900.00","$8,235,965.65",21690568
25-08,DEPOSITO EFECTIVO PRACTIC/******7724,5535,,"$2,900.00","$8,233,065.65",21690046
25-08,DEPOSITO EFECTIVO PRACTIC/******7724,5529,,$150.00,"$8,230,165.65",22690093
25-08,DEPOSITO EFECTIVO PRACTIC/******7724,5526,,$150.00,"$8,230,015.65",24690295
25-08,DEPOSITO EFECTIVO PRACTIC/******7724,6560,,$150.00,"$8,229,865.65",22690099
25-08,DEPOSITO EFECTIVO PRACTIC/******7724,9519,,"$2,900.00","$8,229,715.65",21690301
25-08,DEPOSITO EFECTIVO PRACTIC/******7724,6542,,"$2,900.00","$8,226,815.65",21690124
25-08,DEPOSITO EFECTIVO PRACTIC/******7724,5513,,$150.00,"$8,223,915.65",20690324
25-08,DEPOSITO EFECTIVO PRACTIC/******7724,5511,,"$2,800.00","$8,223,765.65",20690324
25-08,DEPOSITO EFECTIVO PRACTIC/******7724,9505,,"$2,900.00","$8,220,965.65",21690032
25-08,DEPOSITO EFECTIVO PRACTIC/******7724,6534,,$150.00,"$8,218,065.65",21690032
25-08,DEPOSITO EFECTIVO PRACTIC/******7724,6531,,$150.00,"$8,217,915.65",21690032
25-08,DEPOSITO EFECTIVO PRACTIC/******7724,9502,,$150.00,"$8,217,765.65",21690404
25-08,DEPOSITO EFECTIVO PRACTIC/******7724,9499,,$150.00,"$8,217,615.65",21690404
25-08,DEPOSITO EFECTIVO PRACTIC/******7724,9496,,$150.00,"$8,217,465.65",21690033
25-08,DEPOSITO EFECTIVO PRACTIC/******7724,3757,,$150.00,"$8,217,315.65",20690157
25-08,DEPOSITO EFECTIVO PRACTIC/******7724,3754,,$150.00,"$8,217,165.65",20690157
24-08,DEPOSITO EFECTIVO PRACTIC/******7724,3731,,"$2,900.00","$8,217,015.65",21690550
24-08,DEPOSITO EFECTIVO PRACTIC/******7724,9470,,$150.00,"$8,214,115.65",22690385
24-08,DEPOSITO EFECTIVO PRACTIC/******7724,6102,,"$2,900.00","$8,213,965.65",21690058
24-08,DEPOSITO EFECTIVO PRACTIC/******7724,3688,,"$2,900.00","$8,211,065.65",21690389
24-08,DEPOSITO EFECTIVO PRACTIC/******7724,2257,,"$2,900.00","$8,208,165.65",21690310
24-08,DEPOSITO EFECTIVO PRACTIC/******7724,3682,,"$2,900.00","$8,205,265.65",21690629
24-08,DEPOSITO EFECTIVO PRACTIC/******7724,9440,,"$2,900.00","$8,202,365.65",21690385
24-08,DEPOSITO EFECTIVO PRACTIC/******7724,6070,,"$1,500.00","$8,199,465.65",24690453
24-08,DEPOSITO EFECTIVO PRACTIC/******7724,9432,,"$2,900.00","$8,197,965.65",21690565
24-08,DEPOSITO EFECTIVO PRACTIC/******7724,9430,,"$2,900.00","$8,195,065.65",21690541
24-08,DEPOSITO EFECTIVO PRACTIC/******7724,5175,,"$2,900.00","$8,192,165.65",21690237
24-08,DEPOSITO EFECTIVO PRACTIC/******7724,9368,,"$2,900.00","$8,189,265.65",21690060
24-08,DEPOSITO EFECTIVO PRACTIC/******7724,5168,,"$2,900.00","$8,186,365.65",21690021
24-08,DEPOSITO EFECTIVO PRACTIC/******7724,2850,,"$2,900.00","$8,183,465.65",21690296
24-08,DEPOSITO EFECTIVO PRACTIC/******7724,9063,,"$1,500.00","$8,180,565.65",24690155
24-08,DEPOSITO EFECTIVO PRACTIC/******7724,6004,,"$2,900.00","$8,179,065.65",21690384
24-08,DEPOSITO EFECTIVO PRACTIC/******7724,5135,,"$1,000.00","$8,176,165.65",25690036
24-08,DEPOSITO EFECTIVO PRACTIC/******7724,1696,,"$1,900.00","$8,175,165.65",21690249
24-08,DEPOSITO EFECTIVO PRACTIC/******7724,1692,,"$2,900.00","$8,173,265.65",21690319
24-08,DEPOSITO EFECTIVO PRACTIC/******7724,5866,,"$2,900.00","$8,170,365.65",21690018
24-08,DEPOSITO EFECTIVO PRACTIC/******7724,8044,,"$2,900.00","$8,167,465.65",21690307
24-08,DEPOSITO EFECTIVO PRACTIC/******7724,9200,,"$2,900.00","$8,164,565.65",21690561
24-08,DEPOSITO EFECTIVO PRACTIC/******7724,2794,,$150.00,"$8,161,665.65",23690655
24-08,DEPOSITO EFECTIVO PRACTIC/******7724,0156,,$500.00,"$8,161,515.65",24690094
24-08,DEPOSITO EFECTIVO PRACTIC/******7724,0151,,"$2,900.00","$8,161,015.65",21690079
24-08,DEPOSITO EFECTIVO PRACTIC/******7724,5040,,"$2,900.00","$8,158,115.65",21690635
24-08,DEPOSITO EFECTIVO PRACTIC/******7724,2775,,$100.00,"$8,155,215.65",25690575
24-08,DEPOSITO EFECTIVO PRACTIC/******7724,9068,,"$2,900.00","$8,155,115.65",21690031
24-08,DEPOSITO EFECTIVO PRACTIC/******7724,9066,,"$2,900.00","$8,152,215.65",21690024
24-08,DEPOSITO EFECTIVO PRACTIC/******7724,5658,,"$2,900.00","$8,149,315.65",21690330
24-08,DEPOSITO EFECTIVO PRACTIC/******7724,9012,,"$1,500.00","$8,146,415.65",24690011
24-08,DEPOSITO EFECTIVO PRACTIC/******7724,9010,,"$1,400.00","$8,144,915.65",24690011
23-08,DEPOSITO EFECTIVO PRACTIC/******7724,3486,,$100.00,"$8,143,515.65",25690261
23-08,DEPOSITO EFECTIVO PRACTIC/******7724,8380,,"$2,900.00","$8,143,415.65",21690270
23-08,DEPOSITO EFECTIVO PRACTIC/******7724,8373,,"$2,600.00","$8,140,515.65",24690003
23-08,DEPOSITO EFECTIVO PRACTIC/******7724,6785,,"$2,900.00","$8,137,915.65",21690071
23-08,DEPOSITO EFECTIVO PRACTIC/******7724,4743,,"$2,900.00","$8,135,015.65",21690038
23-08,DEPOSITO EFECTIVO PRACTIC/******7724,8255,,"$2,900.00","$8,132,115.65",21690331
23-08,DEPOSITO EFECTIVO PRACTIC/******7724,5282,,"$2,900.00","$8,129,215.65",21690402
23-08,DEPOSITO EN EFECTIVO,,,$100.00,"$8,126,315.65",25690491
23-08,DEPOSITO EFECTIVO PRACTIC/******7724,8232,,"$2,900.00","$8,126,215.65",21690025
23-08,DEPOSITO EFECTIVO PRACTIC/******7724,8230,,"$2,900.00","$8,123,315.65",21690627
23-08,DEPOSITO EFECTIVO PRACTIC/******7724,9893,,"$1,500.00","$8,120,415.65",25690333
23-08,DEPOSITO EFECTIVO PRACTIC/******7724,4674,,"$2,900.00","$8,118,915.65",21690098
23-08,DEPOSITO EFECTIVO PRACTIC/******7724,5177,,"$2,900.00","$8,116,015.65",21690447
23-08,DEPOSITO EFECTIVO PRACTIC/******7724,4643,,"$2,900.00","$8,113,115.65",21690092
23-08,DEPOSITO EFECTIVO PRACTIC/******7724,8123,,"$2,900.00","$8,110,215.65",21690379
23-08,DEPOSITO EFECTIVO PRACTIC/******7724,8120,,"$2,900.00","$8,107,315.65",21690404
23-08,DEPOSITO EFECTIVO PRACTIC/******7724,3038,,"$1,900.00","$8,104,415.65",21690545
23-08,DEPOSITO EFECTIVO PRACTIC/******7724,3024,,"$2,900.00","$8,102,515.65",21690311
23-08,DEPOSITO EFECTIVO PRACTIC/******7724,5115,,"$2,900.00","$8,099,615.65",21690052
23-08,CHEQUE PAGADO NO./0008899,,"$24,979.99",,"$8,096,715.65",25690524
23-08,1570396284,,,"$2,500.00","$8,121,695.64",
23-08,DEPOSITO EFECTIVO PRACTIC/******7724,4020,,$150.00,"$8,119,195.64",24690500
23-08,DEPOSITO EFECTIVO PRACTIC/******7724,4018,,"$3,500.00","$8,119,045.64",21690007
22-08,DEPOSITO EFECTIVO PRACTIC/******7724,3740,,"$1,500.00","$8,115,545.64",
22-08,DEPOSITO EFECTIVO PRACTIC/******7724,9641,,"$2,900.00","$8,114,045.64",21690325
22-08,DEPOSITO EFECTIVO PRACTIC/******7724,6313,,"$2,900.00","$8,111,145.64",21690266
22-08,DEPOSITO EFECTIVO PRACTIC/******7724,7356,,"$2,900.00","$8,108,245.64",
22-08,DEPOSITO EFECTIVO PRACTIC/******7724,7334,,"$1,500.00","$8,105,345.64",24690439
22-08,DEPOSITO EFECTIVO PRACTIC/******7724,4395,,"$2,900.00","$8,103,845.64",21690235
22-08,DEPOSITO EFECTIVO PRACTIC/******7724,4392,,"$2,400.00","$8,100,945.64",21690315
22-08,DEPOSITO EFECTIVO PRACTIC/******7724,8789,,$500.00,"$8,098,545.64",21690315
22-08,DEPOSITO EFECTIVO PRACTIC/******7724,4286,,"$2,900.00","$8,098,045.64",21690631
22-08,DEPOSITO EFECTIVO PRACTIC/******7724,4373,,"$2,900.00","$8,095,145.64",24690286
22-08,ITCV24690286 4541 FOLIO:4373,,,"$2,900.00","$8,092,245.64",
22-08,DEPOSITO EFECTIVO PRACTIC/******7724,7297,,"$2,900.00","$8,089,345.64",21690033
22-08,CHEQUE PAGADO NO./CH-0008883,,"$7,890.00",,"$8,086,445.64",
22-08,DEPOSITO EFECTIVO PRACTIC/******7724,4252,,"$2,900.00","$8,094,335.64",21690186
22-08,DEPOSITO EFECTIVO PRACTIC/******7724,2237,,"$2,900.00","$8,091,435.64",21690259
22-08,DEPOSITO EFECTIVO PRACTIC/******7724,4328,,"$3,500.00","$8,088,535.64",21690254
22-08,DEPOSITO EFECTIVO PRACTIC/******7724,3667,,"$2,900.00","$8,085,035.64",21690238
22-08,DEPOSITO EFECTIVO PRACTIC/******7724,4223,,$300.00,"$8,082,135.64",21690643
22-08,DEPOSITO EFECTIVO PRACTIC/******7724,4221,,"$2,900.00","$8,081,835.64",21690251
22-08,DEPOSITO EFECTIVO PRACTIC/******7724,2714,,"$2,900.00","$8,078,935.64",21690215
22-08,ITCV21690215 E254 FOLIO:2714,,,"$2,900.00","$8,076,035.64",
22-08,DEPOSITO EFECTIVO PRACTIC/******7724,4274,,"$2,900.00","$8,073,135.64",20690364
22-08,DEPOSITO EFECTIVO PRACTIC/******7724,2667,,"$2,900.00","$8,070,235.64",21690613
22-08,21690613 5507 FOLIO:2667,,,"$2,900.00","$8,067,335.64",
22-08,DEPOSITO EFECTIVO PRACTIC/******7724,2643,,"$3,500.00","$8,064,435.64",21690521
22-08,DEPOSITO EFECTIVO PRACTIC/******7724,4189,,"$1,100.00","$8,060,935.64",23690210
22-08,DEPOSITO EFECTIVO PRACTIC/******7724,4251,,"$3,500.00","$8,059,835.64",21690176
22-08,DEPOSITO EFECTIVO PRACTIC/******7724,4246,,"$1,000.00","$8,056,335.64",25690708
22-08,DEPOSITO EFECTIVO PRACTIC/******7724,4244,,"$3,500.00","$8,055,335.64",25690708
22-08,DEPOSITO EFECTIVO PRACTIC/******7724,4140,,"$2,900.00","$8,051,835.64",21690327
22-08,DEPOSITO EFECTIVO PRACTIC/******7724,2641,,"$3,500.00","$8,048,935.64",24690254
22-08,DEPOSITO EFECTIVO PRACTIC/******7724,3618,,"$2,900.00","$8,045,435.64",21690303
22-08,ITCV 21690303 6052 FOLIO:3618,,,"$3,500.00","$8,042,535.64",
22-08,DEPOSITO EFECTIVO PRACTIC/******7724,9481,,"$2,900.00","$8,039,035.64",21690213
22-08,DEPOSITO EFECTIVO PRACTIC/******7724,4101,,"$3,500.00","$8,036,135.64",25690707
22-08,DEPOSITO EFECTIVO PRACTIC/******7724,7119,,"$2,900.00","$8,032,635.64",20690367
22-08,ITCV20690367 4542 FOLIO:7119,,,"$2,900.00","$8,029,735.64",
22-08,DEPOSITO EFECTIVO PRACTIC/******7724,7111,,"$2,900.00","$8,026,835.64",25690674
22-08,DEPOSITO EFECTIVO PRACTIC/******7724,4071,,"$3,500.00","$8,023,935.64",20690294
22-08,DEPOSITO EFECTIVO PRACTIC/******7724,4068,,"$2,900.00","$8,020,435.64",21690236
22-08,DEPOSITO EFECTIVO PRACTIC/******7724,4140,,"$2,900.00","$8,017,535.64",21690625
22-08,DEPOSITO EFECTIVO PRACTIC/******7724,4066,,"$3,500.00","$8,014,635.64",21690468
22-08,DEPOSITO EFECTIVO PRACTIC/******7724,4064,,"$3,500.00","$8,011,135.64",21690566
22-08,DEPOSITO EFECTIVO PRACTIC/******7724,4062,,"$3,500.00","$8,007,635.64",21690484
22-08,DEPOSITO EFECTIVO PRACTIC/******7724,4060,,"$3,500.00","$8,004,135.64",21690482
22-08,DEPOSITO EFECTIVO PRACTIC/******7724,4058,,"$3,500.00","$8,000,635.64",
22-08,DEPOSITO EFECTIVO PRACTIC/******7724,4056,,"$3,500.00","$7,997,135.64",21690457
22-08,DEPOSITO EFECTIVO PRACTIC/******7724,4054,,"$3,500.00","$7,993,635.64",21690587
22-08,DEPOSITO EFECTIVO PRACTIC/******7724,3577,,"$2,900.00","$7,990,135.64",22690541
22-08,ITCV22690541 6052 FOLIO:3577,,,$300.00,"$7,987,235.64",
22-08,DEPOSITO EFECTIVO PRACTIC/******7724,4036,,"$2,900.00","$7,986,935.64",21690072
22-08,DEPOSITO EFECTIVO PRACTIC/******7724,2572,,$200.00,"$7,984,035.64",
22-08,DEPOSITO EFECTIVO PRACTIC/******7724,4085,,"$2,500.00","$7,983,835.64",23690120
22-08,DEPOSITO EFECTIVO PRACTIC/******7724,2569,,"$2,900.00","$7,981,335.64",
22-08,DEPOSITO EFECTIVO PRACTIC/******7724,2563,,"$2,900.00","$7,978,435.64",
22-08,DEPOSITO EFECTIVO PRACTIC/******7724,3551,,"$2,500.00","$7,975,535.64",23690122
22-08,DEPOSITO EFECTIVO PRACTIC/******7724,3538,,"$3,500.00","$7,973,035.64",23690209
22-08,DEPOSITO EFECTIVO PRACTIC/******7724,3536,,"$2,900.00","$7,969,535.64",23690013
22-08,CHEQUE PAGADO NO./CH-0008887,,"$11,468.18",,"$7,966,635.64",
22-08,DEPOSITO EFECTIVO PRACTIC/******7724,3965,,"$2,900.00","$7,978,103.82",21690546
22-08,CHEQUE PAGADO NO./CH-0008898,,"$20,816.66",,"$7,975,203.82",
22-08,DEPOSITO EFECTIVO PRACTIC/******7724,6961,,"$2,900.00","$7,996,020.48",21690513
22-08,DEPOSITO EFECTIVO PRACTIC/******7724,4034,,"$3,500.00","$7,993,120.48",22690004
22-08,DEPOSITO EFECTIVO PRACTIC/******7724,4023,,$150.00,"$7,989,620.48",21690058
22-08,DEPOSITO EFECTIVO PRACTIC/******7724,4006,,"$2,900.00","$7,989,470.48",23690311
22-08,DEPOSITO EFECTIVO PRACTIC/******7724,2144,,"$2,900.00","$7,986,570.48",21690152
21-08,DEPOSITO EFECTIVO PRACTIC/******7724,9342,,"$3,500.00","$7,983,670.48",24690618
21-08,DEPOSITO EFECTIVO PRACTIC/******7724,9340,,"$2,900.00","$7,980,170.48",21690135
21-08,DEPOSITO EFECTIVO PRACTIC/******7724,3216,,"$2,900.00","$7,977,270.48",20690021
21-08,DEPOSITO EFECTIVO PRACTIC/******7724,1265,,"$2,900.00","$7,974,370.48",21690250
21-08,DEPOSITO EFECTIVO PRACTIC/******7724,1261,,"$2,900.00","$7,971,470.48",21690189
21-08,DEPOSITO EFECTIVO PRACTIC/******7724,9296,,"$2,900.00","$7,968,570.48",20690346
21-08,DEPOSITO EFECTIVO PRACTIC/******7724,2123,,"$2,900.00","$7,965,670.48",21690210
21-08,DEPOSITO EFECTIVO PRACTIC/******7724,2121,,"$2,900.00","$7,962,770.48",21690233
21-08,DEPOSITO EFECTIVO PRACTIC/******7724,3808,,"$2,900.00","$7,959,870.48",21690133
21-08,DEPOSITO EFECTIVO PRACTIC/******7724,7566,,"$3,500.00","$7,956,970.48",
21-08,DEPOSITO EFECTIVO PRACTIC/******7724,3798,,"$2,900.00","$7,953,470.48",21690180
21-08,PAGO CUENTA DE TERCERO/ 0099037058,,,$500.00,"$7,950,570.48",24690155
21-08,DEPOSITO EFECTIVO PRACTIC/******7724,2098,,"$2,900.00","$7,950,070.48",20690098
21-08,DEPOSITO EFECTIVO PRACTIC/******7724,3841,,"$2,900.00","$7,947,170.48",21690179
21-08,DEPOSITO EFECTIVO PRACTIC/******7724,3838,,"$2,900.00","$7,944,270.48",21690494
21-08,21690494 4541 FOLIO:3838,,,"$1,200.00","$7,941,370.48",
21-08,DEPOSITO EFECTIVO PRACTIC/******7724,3826,,"$2,900.00","$7,940,170.48",21690145
21-08,CHEQUE PAGADO NO./CH-0008897,,"$24,980.00",,"$7,937,270.48",
21-08,CHEQUE PAGADO NO./CH-0008894,,"$12,355.20",,"$7,962,250.48",
21-08,DEPOSITO EFECTIVO PRACTIC/******7724,6785,,$600.00,"$7,974,605.68",23690146
21-08,DEPOSITO EFECTIVO PRACTIC/******7724,7900,,"$2,900.00","$7,974,005.68",21690162
21-08,DEPOSITO EFECTIVO PRACTIC/******7724,7897,,"$2,900.00","$7,971,105.68",21690344
21-08,DEPOSITO EFECTIVO PRACTIC/******7724,3799,,"$2,900.00","$7,968,205.68",21690449
21-08,DEPOSITO EFECTIVO PRACTIC/******7724,2008,,"$2,900.00","$7,965,305.68",21690559
21-08,DEPOSITO EFECTIVO PRACTIC/******7724,3727,,"$2,900.00","$7,962,405.68",21690348
21-08,21690348 4543 FOLIO:3727,,,"$2,900.00","$7,959,505.68",
21-08,DEPOSITO EFECTIVO PRACTIC/******7724,3724,,"$2,900.00","$7,956,605.68",21690063
21-08,C21690063 4543 FOLIO:3724,,,"$3,500.00","$7,953,705.68",
21-08,DEPOSITO EFECTIVO PRACTIC/******7724,2058,,"$2,900.00","$7,950,205.68",21690218
21-08,DEPOSITO EFECTIVO PRACTIC/******7724,9166,,"$2,900.00","$7,947,305.68",
21-08,DEPOSITO EFECTIVO PRACTIC/******7724,3697,,"$1,000.00","$7,944,405.68",24690058
21-08,DEPOSITO EFECTIVO PRACTIC/******7724,9155,,"$1,000.00","$7,943,405.68",25690447
21-08,DEPOSITO EFECTIVO PRACTIC/******7724,3695,,"$2,900.00","$7,942,405.68",24690058
21-08,DEPOSITO EFECTIVO PRACTIC/******7724,3660,,"$3,500.00","$7,939,505.68",23690009
21-08,C23690009 4543 FOLIO:3660,,,"$3,500.00","$7,936,005.68",
21-08,DEPOSITO EFECTIVO PRACTIC/******7724,8118,,"$3,500.00","$7,932,505.68",23690676
21-08,23690676 A612 FOLIO:8118,,,"$3,500.00","$7,929,005.68",
21-08,DEPOSITO EFECTIVO PRACTIC/******7724,6672,,"$2,900.00","$7,925,505.68",21690269
21-08,DEPOSITO EFECTIVO PRACTIC/******7724,3665,,"$3,500.00","$7,922,605.68",
21-08,DEPOSITO EFECTIVO PRACTIC/******7724,3100,,"$2,000.00","$7,919,105.68",25690021
21-08,DEPOSITO EFECTIVO PRACTIC/******7724,9120,,$150.00,"$7,917,105.68",21690155
21-08,DEPOSITO EFECTIVO PRACTIC/******7724,6656,,"$2,900.00","$7,916,955.68",21690636
21-08,DEPOSITO EFECTIVO PRACTIC/******7724,9117,,"$3,500.00","$7,914,055.68",21690332
21-08,DEPOSITO EFECTIVO PRACTIC/******7724,9115,,"$3,500.00","$7,910,555.68",21690155
21-08,PAGO CUENTA DE TERCERO/ 0019735802,,,"$1,750.00","$7,907,055.68",
21-08,DEPOSITO EFECTIVO PRACTIC/******7724,3572,,"$2,900.00","$7,905,305.68",21690053
21-08,DEPOSITO EFECTIVO PRACTIC/******7724,3570,,"$2,900.00","$7,902,405.68",21690524
21-08,DEPOSITO EFECTIVO PRACTIC/******7724,9053,,"$3,500.00","$7,899,505.68",21690150
21-08,21690150 6053 FOLIO:9053,,,"$2,900.00","$7,896,005.68",
21-08,DEPOSITO EFECTIVO PRACTIC/******7724,3043,,"$2,000.00","$7,893,105.68",25690704
21-08,DEPOSITO EFECTIVO PRACTIC/******7724,3526,,"$3,500.00","$7,891,105.68",23690781
21-08,DEPOSITO EFECTIVO PRACTIC/******7724,3012,,"$2,900.00","$7,887,605.68",21690558
20-08,DEPOSITO EFECTIVO PRACTIC/******7724,7819,,"$1,750.00","$7,884,705.68",25690694
20-08,DEPOSITO EFECTIVO PRACTIC/******7724,7810,,"$1,000.00","$7,882,955.68",21690560
20-08,DEPOSITO EFECTIVO PRACTIC/******7724,7808,,"$1,900.00","$7,881,955.68",21690560
20-08,PAGO CUENTA DE TERCERO/ 0093028790,,,"$1,900.00","$7,880,055.68",
20-08,DEPOSITO EFECTIVO PRACTIC/******7724,3384,,"$2,900.00","$7,878,155.68",20690358
20-08,DEPOSITO EFECTIVO PRACTIC/******7724,1751,,"$1,900.00","$7,875,255.68",21690593
20-08,DEPOSITO EFECTIVO PRACTIC/******7724,3367,,$100.00,"$7,873,355.68",23690375
20-08,DEPOSITO EFECTIVO PRACTIC/******7724,3365,,"$1,900.00","$7,873,255.68",23690375
20-08,DEPOSITO EFECTIVO PRACTIC/******7724,3363,,"$2,900.00","$7,871,355.68",23690375
20-08,DEPOSITO EFECTIVO PRACTIC/******7724,8739,,$300.00,"$7,868,455.68",23690636
20-08,DEPOSITO EFECTIVO PRACTIC/******7724,3331,,"$2,900.00","$7,868,155.68",21690569
20-08,DEPOSITO EFECTIVO PRACTIC/******7724,4610,,"$2,900.00","$7,865,255.68",21690488
20-08,DEPOSITO EFECTIVO PRACTIC/******7724,0501,,"$2,000.00","$7,862,355.68",25690419
20-08,DEPOSITO EFECTIVO PRACTIC/******7724,6343,,"$2,900.00","$7,860,355.68",21690163
20-08,DEPOSITO EFECTIVO PRACTIC/******7724,8709,,"$3,500.00","$7,857,455.68",25690702
20-08,PAGO CUENTA DE TERCERO/ 0094894885,,,"$1,750.00","$7,853,955.68",25690681
20-08,DEPOSITO EFECTIVO PRACTIC/******7724,2879,,"$2,900.00","$7,852,205.68",21690165
20-08,DEPOSITO EFECTIVO PRACTIC/******7724,3288,,"$2,900.00","$7,849,305.68",25690703
20-08,DEPOSITO EFECTIVO PRACTIC/******7724,9290,,"$1,750.00","$7,846,405.68",25690678
20-08,DEPOSITO EFECTIVO PRACTIC/******7724,4117,,"$3,500.00","$7,844,655.68",21690204
20-08,DEPOSITO EFECTIVO PRACTIC/******7724,1683,,"$3,500.00","$7,841,155.68",21690608
20-08,DEPOSITO EFECTIVO PRACTIC/******7724,3264,,"$1,900.00","$7,837,655.68",
20-08,DEPOSITO EFECTIVO PRACTIC/******7724,1680,,"$1,750.00","$7,835,755.68",
20-08,DEPOSITO EFECTIVO PRACTIC/******7724,1676,,"$3,500.00","$7,834,005.68",21690299
20-08,DEPOSITO EFECTIVO PRACTIC/******7724,0924,,"$2,900.00","$7,830,505.68",21690214
20-08,DEPOSITO EFECTIVO PRACTIC/******7724,1653,,"$1,900.00","$7,827,605.68",
20-08,PAGO CUENTA DE TERCERO/ 0059649913,,,"$1,750.00","$7,825,705.68",25690676
20-08,PAGO CUENTA DE TERCERO/ 0030007607,,,$148.00,"$7,823,955.68",
20-08,DEPOSITO EFECTIVO PRACTIC/******7724,3173,,"$1,750.00","$7,823,807.68",25690679
20-08,DEPOSITO EFECTIVO PRACTIC/******7724,2570,,"$3,500.00","$7,822,057.68",25690077
20-08,DEPOSITO EFECTIVO PRACTIC/******7724,2564,,"$1,900.00","$7,818,557.68",
20-08,DEPOSITO EFECTIVO PRACTIC/******7724,7032,,$500.00,"$7,816,657.68",24690453
20-08,DEPOSITO EFECTIVO PRACTIC/******7724,2675,,"$2,900.00","$7,816,157.68",21690147
20-08,DEPOSITO EFECTIVO PRACTIC/******7724,2622,,"$2,900.00","$7,813,257.68",23690249
20-08,ITCV23690249 4541 FOLIO:2622,,,"$2,000.00","$7,810,357.68",
20-08,PAGO CUENTA DE TERCERO/ 0064020778,,,"$1,750.00","$7,808,357.68",53690638
20-08,DEPOSITO EFECTIVO PRACTIC/******7724,8497,,$150.00,"$7,806,607.68",23690050
19-08,DEPOSITO EFECTIVO PRACTIC/******7724,8486,,"$2,900.00","$7,806,457.68",22690118
19-08,DEPOSITO EFECTIVO PRACTIC/******7724,8484,,"$3,500.00","$7,803,557.68",22690420
19-08,DEPOSITO EFECTIVO PRACTIC/******7724,2392,,"$3,500.00","$7,800,057.68",21690188
19-08,DEPOSITO EFECTIVO PRACTIC/******7724,2390,,"$3,500.00","$7,796,557.68",21690192
19-08,DEPOSITO EFECTIVO PRACTIC/******7724,2377,,"$2,900.00","$7,793,057.68",25690210
19-08,DEPOSITO EFECTIVO PRACTIC/******7724,2858,,"$2,900.00","$7,790,157.68",21690644
19-08,DEPOSITO EFECTIVO PRACTIC/******7724,2801,,"$3,500.00","$7,787,257.68",21690185
19-08,SPEI RECIBIDOBANK OF AMER/0148131750 106,,,"$2,500.00","$7,783,757.68",22690010
19-08,SPEI RECIBIDOBANK OF AMER/0148131534 106,,,"$2,500.00","$7,781,257.68",23690059
19-08,DEPOSITO EFECTIVO PRACTIC/******7724,2765,,"$2,900.00","$7,778,757.68",21690172
19-08,CHEQUE PAGADO NO./CH-0008886,,"$19,555.10",,"$7,775,857.68",
19-08,CHEQUE PAGADO NO./CH-0008856,,"$7,494.00",,"$7,795,412.78",
19-08,DEPOSITO EFECTIVO PRACTIC/******7724,2715,,"$2,900.00","$7,802,906.78",21690193
19-08,DEPOSITO EFECTIVO PRACTIC/******7724,1279,,"$1,750.00","$7,800,006.78",25690691
19-08,DEPOSITO EFECTIVO PRACTIC/******7724,1246,,"$2,900.00","$7,798,256.78",21690195
19-08,DEPOSITO EFECTIVO PRACTIC/******7724,1244,,"$2,900.00","$7,795,356.78",21690178
19-08,21690178 5507 FOLIO:1244,,,"$3,500.00","$7,792,456.78",25690010
19-08,DEPOSITO EN EFECTIVO/008591425690010,,,"$3,500.00","$7,788,956.78",25690010
19-08,DEPOSITO EN EFECTIVO/008591325690063,,,"$1,000.00","$7,785,456.78",25690063
19-08,DEPOSITO EN EFECTIVO/008591225690063,,,"$3,500.00","$7,784,456.78",25690063
19-08,DEPOSITO EFECTIVO PRACTIC/******7724,5640,,"$1,000.00","$7,780,956.78",25690283
19-08,DEPOSITO EFECTIVO PRACTIC/******7724,2582,,"$2,900.00","$7,779,956.78",21690343
19-08,DEPOSITO EFECTIVO PRACTIC/******7724,5638,,"$2,900.00","$7,777,056.78",25690283
19-08,DEPOSITO EFECTIVO PRACTIC/******7724,5636,,"$2,000.00","$7,774,156.78",25690057
19-08,4394 4542 FOLIO:5636,,,"$2,900.00","$7,772,156.78",
19-08,DEPOSITO EFECTIVO PRACTIC/******7724,8717,,"$1,750.00","$7,769,256.78",25690685
19-08,DEPOSITO EFECTIVO PRACTIC/******7724,2173,,"$2,900.00","$7,767,506.78",21690342
19-08,DEPOSITO EFECTIVO PRACTIC/******7724,2510,,"$1,000.00","$7,764,606.78",25690022
19-08,DEPOSITO EFECTIVO PRACTIC/******7724,2502,,"$2,500.00","$7,763,606.78",24690635
19-08,CHEQUE PAGADO NO./CH-0008872,,"$15,175.35",,"$7,761,106.78",
19-08,DEPOSITO EFECTIVO PRACTIC/******7724,1158,,"$1,500.00","$7,776,282.13",23690619
19-08,CHEQUE PAGADO NO./CH-0008859,,"$9,884.16",,"$7,774,782.13",
18-08,DEPOSITO EFECTIVO PRACTIC/******7724,2477,,"$1,750.00","$7,784,666.29",25690680
18-08,DEPOSITO EFECTIVO PRACTIC/******7724,1124,,"$1,000.00","$7,782,916.29",25690282
18-08,DEPOSITO EFECTIVO PRACTIC/******7724,2473,,"$1,000.00","$7,781,916.29",25690269
18-08,DEPOSITO EFECTIVO PRACTIC/******7724,5483,,"$2,900.00","$7,780,916.29",
18-08,DEPOSITO EFECTIVO PRACTIC/******7724,5481,,"$1,000.00","$7,778,016.29",
18-08,DEPOSITO EFECTIVO PRACTIC/******7724,8133,,"$2,000.00","$7,777,016.29",25690395
18-08,DEPOSITO EFECTIVO PRACTIC/******7724,8130,,"$2,900.00","$7,775,016.29",25690395
18-08,DEPOSITO EFECTIVO PRACTIC/******7724,5479,,"$2,900.00","$7,772,116.29",
18-08,DEPOSITO EFECTIVO PRACTIC/******7724,5477,,"$3,500.00","$7,769,216.29",
18-08,DEPOSITO EFECTIVO PRACTIC/******7724,9741,,"$2,900.00","$7,765,716.29",21690429
18-08,DEPOSITO EFECTIVO PRACTIC/******7724,1527,,"$1,000.00","$7,762,816.29",25690210
18-08,DEPOSITO EFECTIVO PRACTIC/******7724,2449,,"$1,000.00","$7,761,816.29",25694099
18-08,DEPOSITO EFECTIVO PRACTIC/******7724,1519,,"$2,900.00","$7,760,816.29",
18-08,DEPOSITO EFECTIVO PRACTIC/******7724,2445,,"$2,000.00","$7,757,916.29",25690017
18-08,DEPOSITO EFECTIVO PRACTIC/******7724,2438,,"$2,900.00","$7,755,916.29",25690017
18-08,DEPOSITO EFECTIVO PRACTIC/******7724,2094,,"$2,000.00","$7,753,016.29",25690068
18-08,DEPOSITO EFECTIVO PRACTIC/******7724,1102,,"$2,900.00","$7,751,016.29",25690665
18-08,DEPOSITO EFECTIVO PRACTIC/******7724,2091,,"$2,900.00","$7,748,116.29",25690068
18-08,DEPOSITO EFECTIVO PRACTIC/******7724,5441,,"$2,900.00","$7,745,216.29",21690401
18-08,DEPOSITO EFECTIVO PRACTIC/******7724,1506,,"$3,500.00","$7,742,316.29",
18-08,DEPOSITO EFECTIVO PRACTIC/******7724,2424,,$600.00,"$7,738,816.29",23690053
18-08,DEPOSITO EFECTIVO PRACTIC/******7724,2420,,"$1,000.00","$7,738,216.29",25690126
18-08,DEPOSITO EFECTIVO PRACTIC/******7724,5424,,"$1,000.00","$7,737,216.29",25690647
18-08,DEPOSITO EFECTIVO PRACTIC/******7724,2417,,"$2,900.00","$7,736,216.29",25690126
18-08,DEPOSITO EFECTIVO PRACTIC/******7724,1088,,"$1,000.00","$7,733,316.29",25690584
18-08,DEPOSITO EFECTIVO PRACTIC/******7724,5422,,"$2,900.00","$7,732,316.29",25690647
18-08,DEPOSITO EFECTIVO PRACTIC/******7724,1493,,"$2,900.00","$7,729,416.29",25690116
18-08,DEPOSITO EFECTIVO PRACTIC/******7724,1490,,"$3,100.00","$7,726,516.29",22690223
18-08,DEPOSITO EFECTIVO PRACTIC/******7724,1488,,"$2,000.00","$7,723,416.29",25690533
18-08,DEPOSITO EFECTIVO PRACTIC/******7724,1086,,"$2,900.00","$7,721,416.29",
18-08,DEPOSITO EFECTIVO PRACTIC/******7724,1486,,"$3,500.00","$7,718,516.29",25690533
18-08,DEPOSITO EFECTIVO PRACTIC/******7724,2074,,"$1,000.00","$7,715,016.29",25690369
18-08,DEPOSITO EFECTIVO PRACTIC/******7724,2071,,"$2,900.00","$7,714,016.29",25690369
18-08,DEPOSITO EFECTIVO PRACTIC/******7724,1480,,"$1,000.00","$7,711,116.29",25690391
18-08,DEPOSITO EFECTIVO PRACTIC/******7724,8087,,"$1,000.00","$7,710,116.29",25690089
18-08,DEPOSITO EFECTIVO PRACTIC/******7724,8085,,"$2,900.00","$7,709,116.29",25690089
18-08,DEPOSITO EFECTIVO PRACTIC/******7724,1462,,"$2,900.00","$7,706,216.29",25690384
18-08,DEPOSITO EFECTIVO PRACTIC/******7724,1460,,"$1,000.00","$7,703,316.29",25690384
18-08,DEPOSITO EFECTIVO PRACTIC/******7724,2385,,"$1,000.00","$7,702,316.29",25690119
18-08,DEPOSITO EFECTIVO PRACTIC/******7724,2381,,"$1,000.00","$7,701,316.29",25690163
18-08,DEPOSITO EFECTIVO PRACTIC/******7724,5391,,"$2,000.00","$7,700,316.29",25690074
18-08,DEPOSITO EFECTIVO PRACTIC/******7724,2379,,"$2,900.00","$7,698,316.29",25690163
18-08,DEPOSITO EFECTIVO PRACTIC/******7724,6126,,"$2,900.00","$7,695,416.29",21690158
18-08,DEPOSITO EFECTIVO PRACTIC/******7724,1442,,"$1,000.00","$7,692,516.29",25690014
18-08,DEPOSITO EFECTIVO PRACTIC/******7724,2029,,"$1,000.00","$7,691,516.29",23690767
18-08,DEPOSITO EFECTIVO PRACTIC/******7724,2368,,"$2,900.00","$7,690,516.29",
18-08,DEPOSITO EFECTIVO PRACTIC/******7724,5374,,"$2,000.00","$7,687,616.29",25690588
18-08,DEPOSITO EFECTIVO PRACTIC/******7724,1439,,"$2,900.00","$7,685,616.29",25690014
18-08,DEPOSITO EFECTIVO PRACTIC/******7724,9948,,"$2,000.00","$7,682,716.29",
18-08,DEPOSITO EFECTIVO PRACTIC/******7724,5369,,"$1,000.00","$7,680,716.29",25690308
18-08,DEPOSITO EFECTIVO PRACTIC/******7724,9945,,"$2,900.00","$7,679,716.29",
18-08,DEPOSITO EFECTIVO PRACTIC/******7724,2366,,"$3,500.00","$7,676,816.29",25690588
18-08,DEPOSITO EFECTIVO PRACTIC/******7724,2023,,"$2,900.00","$7,673,316.29",21690346
18-08,DEPOSITO EFECTIVO PRACTIC/******7724,2353,,"$2,000.00","$7,670,416.29",
18-08,DEPOSITO EFECTIVO PRACTIC/******7724,1418,,"$1,000.00","$7,668,416.29",25690220
18-08,DEPOSITO EFECTIVO PRACTIC/******7724,2351,,"$3,500.00","$7,667,416.29",
18-08,DEPOSITO EFECTIVO PRACTIC/******7724,2018,,"$2,900.00","$7,663,916.29",21690161
18-08,DEPOSITO EFECTIVO PRACTIC/******7724,2015,,"$2,900.00","$7,661,016.29",21690146
18-08,DEPOSITO EFECTIVO PRACTIC/******7724,1412,,"$3,500.00","$7,658,116.29",25690071
18-08,DEPOSITO EFECTIVO PRACTIC/******7724,6698,,"$1,000.00","$7,654,616.29",
18-08,DEPOSITO EFECTIVO PRACTIC/******7724,1410,,"$3,500.00","$7,653,616.29",25690050
18-08,DEPOSITO EFECTIVO PRACTIC/******7724,6696,,"$3,500.00","$7,650,116.29",25690088
18-08,DEPOSITO EFECTIVO PRACTIC/******7724,1033,,"$3,500.00","$7,646,616.29",25690097
18-08,DEPOSITO EFECTIVO PRACTIC/******7724,2338,,"$1,000.00","$7,643,116.29",
18-08,DEPOSITO EFECTIVO PRACTIC/******7724,2336,,"$2,900.00","$7,642,116.29",
18-08,DEPOSITO EFECTIVO PRACTIC/******7724,8051,,"$1,000.00","$7,639,216.29",25690663
18-08,DEPOSITO EFECTIVO PRACTIC/******7724,2002,,"$1,000.00","$7,638,216.29",25690575
18-08,DEPOSITO EFECTIVO PRACTIC/******7724,6336,,"$1,000.00","$7,637,216.29",25690117
18-08,DEPOSITO EFECTIVO PRACTIC/******7724,5321,,$150.00,"$7,636,216.29",21690410
18-08,DEPOSITO EFECTIVO PRACTIC/******7724,8049,,"$1,000.00","$7,636,066.29",25690036
18-08,DEPOSITO EFECTIVO PRACTIC/******7724,5318,,$150.00,"$7,635,066.29",21690410
18-08,DEPOSITO EFECTIVO PRACTIC/******7724,8047,,"$3,500.00","$7,634,916.29",25690036
18-08,DEPOSITO EFECTIVO PRACTIC/******7724,5306,,"$2,900.00","$7,631,416.29",25690307
18-08,DEPOSITO EFECTIVO PRACTIC/******7724,1381,,"$2,900.00","$7,628,516.29",25690266
18-08,DEPOSITO EFECTIVO PRACTIC/******7724,1274,,"$1,000.00","$7,625,616.29",25690440
18-08,DEPOSITO EFECTIVO PRACTIC/******7724,1377,,"$1,000.00","$7,624,616.29",25690355
18-08,DEPOSITO EFECTIVO PRACTIC/******7724,1370,,"$2,900.00","$7,623,616.29",25690355
18-08,DEPOSITO EFECTIVO PRACTIC/******7724,6305,,"$2,900.00","$7,620,716.29",25690117
18-08,DEPOSITO EFECTIVO PRACTIC/******7724,1991,,"$1,000.00","$7,617,816.29",25690371
18-08,DEPOSITO EFECTIVO PRACTIC/******7724,2295,,"$3,500.00","$7,616,816.29",25690188
18-08,DEPOSITO EFECTIVO PRACTIC/******7724,1988,,"$2,900.00","$7,613,316.29",25690371
18-08,DEPOSITO EFECTIVO PRACTIC/******7724,2293,,"$3,500.00","$7,610,416.29",25690032
18-08,DEPOSITO EFECTIVO PRACTIC/******7724,1983,,"$2,000.00","$7,606,916.29",25690554
18-08,DEPOSITO EFECTIVO PRACTIC/******7724,8025,,"$2,000.00","$7,604,916.29",25690187
18-08,DEPOSITO EFECTIVO PRACTIC/******7724,8023,,"$3,500.00","$7,602,916.29",25690187
18-08,DEPOSITO EFECTIVO PRACTIC/******7724,8021,,"$1,000.00","$7,599,416.29",25690432
18-08,DEPOSITO EFECTIVO PRACTIC/******7724,8031,,"$2,900.00","$7,598,416.29",21690171
18-08,DEPOSITO EFECTIVO PRACTIC/******7724,1976,,"$1,000.00","$7,595,516.29",25690451
18-08,DEPOSITO EFECTIVO PRACTIC/******7724,8019,,"$2,900.00","$7,594,516.29",25690432
18-08,DEPOSITO EFECTIVO PRACTIC/******7724,1004,,"$2,900.00","$7,591,616.29",25690663
18-08,DEPOSITO EFECTIVO PRACTIC/******7724,1973,,"$2,900.00","$7,588,716.29",25690451
18-08,DEPOSITO EFECTIVO PRACTIC/******7724,5285,,"$2,900.00","$7,585,816.29",21690574
18-08,DEPOSITO EFECTIVO PRACTIC/******7724,5283,,"$1,000.00","$7,582,916.29",25690430
18-08,DEPOSITO EFECTIVO PRACTIC/******7724,2282,,"$2,900.00","$7,581,916.29",25690328
18-08,DEPOSITO EFECTIVO PRACTIC/******7724,5280,,"$1,750.00","$7,579,016.29",
18-08,DEPOSITO EFECTIVO PRACTIC/******7724,0998,,"$2,900.00","$7,577,266.29",
18-08,DEPOSITO EFECTIVO PRACTIC/******7724,0996,,"$2,000.00","$7,574,366.29",25690118
18-08,DEPOSITO EFECTIVO PRACTIC/******7724,1243,,"$1,900.00","$7,572,366.29",21690140
18-08,DEPOSITO EFECTIVO PRACTIC/******7724,1338,,"$2,000.00","$7,570,466.29",25690243
18-08,INGL 25690243 4541 FOLIO:1338,,,"$1,000.00","$7,568,466.29",
18-08,DEPOSITO EFECTIVO PRACTIC/******7724,0993,,"$2,900.00","$7,567,466.29",25690118
18-08,ITCV25690118 5507 FOLIO:0993,,,"$3,500.00","$7,564,566.29",25690144
18-08,DEPOSITO EN EFECTIVO/008579725690144,,,"$2,000.00","$7,561,066.29",25690144
18-08,DEPOSITO EFECTIVO PRACTIC/******7724,2274,,"$1,000.00","$7,559,066.29",25690535
18-08,CHEQUE PAGADO NO./CH-0008873,,"$10,791.36",,"$7,558,066.29",25690629
18-08,RFC CUENTA DE DEPOSITO:RIVL930919-1F0,,,"$1,000.00","$7,568,857.65",25690268
18-08,DEPOSITO EN EFECTIVO/008579325690268,,,"$1,000.00","$7,567,857.65",25690268
18-08,DEPOSITO EFECTIVO PRACTIC/******7724,0989,,"$1,000.00","$7,566,857.65",25690172
18-08,INGL25690172 5507 FOLIO:0989,,,"$3,500.00","$7,565,857.65",25690629
18-08,DEPOSITO EN EFECTIVO/008579025690629,,,"$3,500.00","$7,562,357.65",25690629
18-08,DEPOSITO EN EFECTIVO/008578925690402,,,"$2,900.00","$7,558,857.65",25690402
18-08,DEPOSITO EN EFECTIVO/008578825690263,,,"$1,000.00","$7,555,957.65",25690263
18-08,DEPOSITO EN EFECTIVO/008578725690263,,,"$2,900.00","$7,554,957.65",25690263
18-08,DEPOSITO EFECTIVO PRACTIC/******7724,0987,,"$2,900.00","$7,552,057.65",25690172
18-08,DEPOSITO EFECTIVO PRACTIC/******7724,1229,,"$1,000.00","$7,549,157.65",25690091
18-08,CHEQUE PAGADO NO./CH-0008865,,"$24,710.39",,"$7,548,157.65",
18-08,DEPOSITO EFECTIVO PRACTIC/******7724,1314,,"$1,000.00","$7,572,868.04",25690192
18-08,DEPOSITO EFECTIVO PRACTIC/******7724,5253,,"$1,000.00","$7,571,868.04",25690429
18-08,INGL25690429 4542 FOLIO:5253,,,"$1,750.00","$7,570,868.04",
18-08,DEPOSITO EFECTIVO PRACTIC/******7724,1227,,"$3,500.00","$7,569,118.04",25690091
18-08,DEPOSITO EFECTIVO PRACTIC/******7724,9854,,"$1,000.00","$7,565,618.04",25690183
18-08,DEPOSITO EFECTIVO PRACTIC/******7724,1312,,"$2,900.00","$7,564,618.04",25690192
18-08,DEPOSITO EFECTIVO PRACTIC/******7724,5250,,"$2,900.00","$7,561,718.04",25690429
18-08,DEPOSITO EFECTIVO PRACTIC/******7724,9852,,"$2,900.00","$7,558,818.04",25690183
18-08,ITCV25690183 D179 FOLIO:9852,,,"$3,500.00","$7,555,918.04",
18-08,DEPOSITO EFECTIVO PRACTIC/******7724,1938,,"$2,900.00","$7,552,418.04",21690440
18-08,DEPOSITO EFECTIVO PRACTIC/******7724,5247,,"$2,900.00","$7,549,518.04",25690430
18-08,25690430 4542 FOLIO:5247,,,"$1,000.00","$7,546,618.04",25690075
18-08,DEPOSITO EN EFECTIVO/008577125690075,,,"$2,900.00","$7,545,618.04",25690075
18-08,DEPOSITO EFECTIVO PRACTIC/******7724,2252,,"$2,900.00","$7,542,718.04",
18-08,DEPOSITO EFECTIVO PRACTIC/******7724,5245,,"$1,000.00","$7,539,818.04",25690322
18-08,DEPOSITO EFECTIVO PRACTIC/******7724,5239,,"$2,000.00","$7,538,818.04",25690659
18-08,DEPOSITO EFECTIVO PRACTIC/******7724,7989,,"$1,000.00","$7,536,818.04",25690052
18-08,DEPOSITO EFECTIVO PRACTIC/******7724,7987,,"$3,500.00","$7,535,818.04",25690052
18-08,DEPOSITO EFECTIVO PRACTIC/******7724,2231,,"$2,900.00","$7,532,318.04",25690509
18-08,ITCV25690509 4543 FOLIO:2231,,,"$1,000.00","$7,529,418.04",
18-08,DEPOSITO EFECTIVO PRACTIC/******7724,5221,,"$1,000.00","$7,528,418.04",25690604
18-08,25690604 4542 FOLIO:5221,,,"$2,900.00","$7,527,418.04",25690201
18-08,DEPOSITO EN EFECTIVO/008576125690201,,,"$3,500.00","$7,524,518.04",25690201
18-08,DEPOSITO EFECTIVO PRACTIC/******7724,2229,,"$1,000.00","$7,521,018.04",25690509
18-08,DEPOSITO EFECTIVO PRACTIC/******7724,7979,,"$1,000.00","$7,520,018.04",25690334
18-08,DEPOSITO EFECTIVO PRACTIC/******7724,5219,,"$2,900.00","$7,519,018.04",25690604
18-08,DEPOSITO EFECTIVO PRACTIC/******7724,2227,,"$3,500.00","$7,516,118.04",25690098
18-08,DEPOSITO EFECTIVO PRACTIC/******7724,5217,,"$2,900.00","$7,512,618.04",25690322
18-08,DEPOSITO EFECTIVO PRACTIC/******7724,1915,,"$1,000.00","$7,509,718.04",25690461
18-08,DEPOSITO EFECTIVO PRACTIC/******7724,2225,,"$1,000.00","$7,508,718.04",25690330
18-08,DEPOSITO EFECTIVO PRACTIC/******7724,7976,,"$2,900.00","$7,507,718.04",25690334
18-08,DEPOSITO EFECTIVO PRACTIC/******7724,8171,,"$1,000.00","$7,504,818.04",25690178
